* Block gas
@ Block wall
. Block floor
8 Block wall
E Block entrance
e Block exit
M Block message mind the gas
#
@@@@@@@@@@@@@@@@@@@@
@@@@@@@@@@@@@@@@@@@@
@...@88888888888@@@@
@.E.@88888888888@@@@
@...@88888888888@@@@
@.M.@@@@@@@@@@@@@@@@
@...************...@
@...*...**...***...@
@...*...**...***...@
@...************...@
@@@@@@@@@@@@@@@@...@
@@@@@@@@@@@@@@@@...@
@@@@@@@@@@@@@@@@.e.@
@@@@@@@@@@@@@@@@...@
@@@@@@@@@@@@@@@@@@@@
@@@@@@@@@@@@@@@@@@@@