W Block wall
. Block floor
e Block entrance
v Block exit
h Item healthPotion
n Block secret
s Block spikes
x Block gas
q Item whiteDoorKey
#
WWWWWWWWWWWWWWWWWWWWWWWWWWWWWWWWWWWWWWWWWWWWWWWWWWWWWWWWWWWWWWWWWWWWWW
WWWWWWWWWWWWWWWWWWWWWWWWWWWWWWWWWWWWWWWWWWWWWWWWWWWWWWWWWWWWWWWWWWWWWW
WWWWWWWWWWWWWWWWWWWWWWWWWWWWWWWWW..n.............x...xx....xxx......WW
WWWWWWWWWWWWWWWWWWWWWWWWWWWWWWWWW..Wsss.........WWWWWWWWWWWWWWW.ssssWW
WWWWWWWWWWWWWWWWWWWWWWWWWWWWWWWWW..Wsss.....sss........hWWWWWWW.....WW
WWWWWWWWWWWWWWWWWWWWWWWWWWWWWWWWW..W......xxxxxxxWWWWWWWWWWWWWWssss.WW
WWWWWWWWWWWWWWWWWWWWWWWWWWWWWWWWW..Wxxxxxx....xxx............WW.....WW
WWWWWWWWWWWWWWWWWWWWWWWWWWWWWWWWW..Wxxxxxx....xxx.....WWWW...WW..sssWW
WWWWWWWWWWWWWWWWWWWWWWWWWWWWWWWWW..WWWWWWWWWWWWWWWWWWWWWWW..WWW.....WW
WWWWWWWWWWWWWWWWWWWWWWWWWWWWWWWWW.....................WWWW..WWWsss..WW
WWWWWWWWWWWWWWWWWWWWWWWWWWWWWWWWW...WWWWWWWWWWWWWWWW..WWWW..WWW.....WW
WWWWWWWWWWWWWWWWWWWWWWWWWWWWWWWWW...WWWWWWWWWWWWWWWW..WWWW..WWW.ssssWW
WWWWWWWWWWWWnnnnnnnnnnnnnnnnnnnnn.................eW..WWWW..WWW.....WW
WWWWWWWWWWWWnWWWWWWWWWWWWWWWWWWWW...WWWWWWWWWWWWWWWWxxWWWW..WWWssss.WW
WWWWWWWWWWWWnWWWWWWWWWWWWWWWWWWWW...W...............xx......WWWWW...WW
WWWWWWWWWWWWnWWWWWWWWWWWWWWWWWWWW...W...............ssWWWWWWWWWWW...WW
WWWWWWWWWWWWnWWWWWWWWWWWWWWWWWWWW...W..WWWWWWWWWWWWWWW...W....hWW...WW
WWWWWWWWW.......WWWWWWWWWWWWWWWWW...W........WW.....W....W.....WW...WW
WWWWWWWWW.......WWWWWWWWWWWWWWWWW...WWWWWWW..WW..W..W.W..W.....WW.xxWW
WWWWWWWWW..q....WWWWWWWWWWWWWWWWW...WWWWWWW......W....W........WWxx.WW
WWWWWWWWW.......WWWWWWWWWWWWWWWWW...WWWWWWWWWWWWWWWWWWWWWWWWWWWWv...WW
WWWWWWWWWWWWWWWWWWWWWWWWWWWWWWWWW...........................hWWW....WW
WWWWWWWWWWWWWWWWWWWWWWWWWWWWWWWWWWWWWWWWWWWWWWWWWWWWWWWWWWWWWWWWWWWWWW
WWWWWWWWWWWWWWWWWWWWWWWWWWWWWWWWWWWWWWWWWWWWWWWWWWWWWWWWWWWWWWWWWWWWWW